################################
#      #       #     #         #
#  ### # ##### # ### # ####### #
#  #   #     # #   # #       # #
#  # ######### ### # ####### # #
#  #       #       #       # # #
##### ### ########### #### # # #
#     #     #         #    # # #
# ######### # ####### ###### # #
#         # # #     #      #   #
######### # # # ### ######### ##
#         #   #   #          # #
# ########### ##### ######## # #
#       #     #   #        # # #
####### # ##### ### ###### # # #
#     # #         #      # #   #
# ### # ############## # # #####
# #   #                # #     #
# # #################### ##### #
# # #                  #       #
# # ################## #########
# #                #           #
# ################## ######### #
#      #           # #       # #
# #### ########### # # ##### # #
#    #           #   #     # # #
##### ########## ###############
#       #                #     #
# ####### ############## #######
#                              #
#                           E  #
################################
